abcd=мир
java=кофе
code=код
alma=яблоко
bake=печь
cool=круто
dawn=рассвет
echo=эхо
fire=огонь
gate=ворота
hope=надежда
iron=железо
jazz=джаз
kite=воздушный змей
lava=лава
mint=мята
node=узел
opal=опал
pine=сосна
quiz=викторина
ruby=рубин
snow=снег
tree=дерево
undo=отмена
vain=тщетный
wolf=волк
xray=рентген
yoga=йога
zero=ноль
aqua=вода
bolt=молния
clay=глина
dust=пыль
nine=девять
